
NO ./textures/mossy.xpm
SO      ./textures/eagle.xpm

WE ./textures/redbrick.xpm
EA ./textures/south.xpm


F 0,0,0
C            255,255,255

    111111111111111111111     111111111      111111111111111111111111111111
    11111111111110000000111111100000001111111100000000000000020000000000111
    100001010110000000000000000000000000000000000000000000001100000000001
    11111001001000111000000000000000000000000000000000000000011111111111111
111 100000000000011000000000000000000000000000000000000000000000000000111
111110000000001111111111111111111121111111111111111111111111111111111000111
  100000000000001             111000000000001           1000000020000000001
11111000000000111           11110000000000111         111111111110000000111
101110000001111               1100000010001           1000000000000000001
111000000001               1111111110000001        111100000000000000000111
  1010000001             111000000000001111        1000000000000000001111
1111100001111             11100000000001         1111100000000000000000111
100010000011            1110000000000011          1000000000000000001111
121W10000001             111000000000001          110000000000000000011111
1011100001111             111000000000011111111111111111000000000000000001
10000000001             11100000000000000000000000000000000000000000011111
111111111111            111111111111111111111111111111111111111111111111
 1  1  1  1



