C 200,20,8
F                   0,45,100

NO ./textures/north.xpm
SO        ./textures/south.xpm
WE ./textures/west.xpm
EA ./textures/east.xpm

1111111111     1111111111
1000000001111111000000001
1000000002000002000000001
1000000001111111000000001
1111211111     1111121111
   101             101
   101             101
   101             101
   101             101
1111211111     1111121111
1000000001111111000000001
1000000002000002000S00001
1000000001111111000000001
1111111111     1111111111